SOLVABLE MAZES:

Input:
{0, 1, 1, 1, 0, 0, 1, 1, 1, 0},
{0, 0, 1, 1, 1, 0, 1, 0, 1, 1},
{0, 0, 1, 0, 0, 0, 1, 1, 1, 0},
{0, 0, 0, 0, 1, 1, 0, 1, 0, 0},
{0, 1, 0, 1, 0, 1, 1, 1, 0, 0},
{0, 0, 0, 1, 0, 1, 0, 1, 0, 1},
{0, 1, 0, 0, 0, 0, 0, 0, 1, 1},
{1, 1, 0, 0, 1, 0, 1, 0, 1, 0},
{0, 1, 0, 0, 0, 0, 1, 0, 0, 0},
{1, 0, 0, 0, 1, 0, 0, 0, 1, 0}};
	
Output:
Labirinto completo! 
2 1 1 1 0 0 1 1 1 0 
2 0 1 1 1 0 1 0 1 1 
2 0 1 0 0 0 1 1 1 0 
2 0 0 0 1 1 0 1 0 0 
2 1 0 1 0 1 1 1 0 0 
2 2 2 1 0 1 0 1 0 1 
0 1 2 0 0 0 0 0 1 1 
1 1 2 0 1 0 1 0 1 0 
0 1 2 2 2 2 1 2 2 2 
1 0 2 2 1 2 2 2 1 2

Input:
{0, 1, 1, 1, 0, 0, 1, 1, 1, 0},
{0, 0, 1, 1, 1, 0, 1, 0, 1, 1},
{0, 0, 1, 0, 0, 0, 1, 1, 1, 0},
{0, 0, 0, 0, 1, 1, 0, 1, 0, 0},
{1, 1, 0, 1, 0, 1, 1, 1, 0, 0},
{0, 0, 0, 1, 0, 1, 0, 0, 0, 0},
{0, 1, 0, 1, 0, 0, 0, 0, 1, 0},
{1, 1, 0, 0, 1, 0, 1, 0, 1, 0},
{0, 1, 1, 0, 0, 0, 1, 0, 1, 0},
{1, 0, 0, 0, 1, 0, 0, 0, 1, 0}};
	
Output:
Labirinto completo! 
2 1 1 1 0 0 1 1 1 0 
2 0 1 1 1 0 1 0 1 1
2 0 1 0 0 0 1 1 1 0
2 2 2 0 1 1 0 1 0 0
1 1 2 1 0 1 1 1 0 0
0 0 2 1 0 1 0 2 2 2
0 1 2 1 0 0 0 2 1 2
1 1 2 2 1 0 1 2 1 2
0 1 1 2 2 2 1 2 1 2
1 0 0 0 1 2 2 2 1 2

UNSOLVABLE MAZE:	
Input:
{0, 1, 1, 1, 0, 0, 1, 1, 1, 0},
{0, 0, 1, 1, 1, 0, 1, 0, 1, 1},
{0, 0, 1, 0, 0, 0, 1, 1, 1, 0},
{0, 0, 0, 0, 1, 1, 0, 1, 0, 0},
{0, 1, 0, 1, 0, 1, 1, 1, 0, 0},
{0, 0, 0, 1, 0, 1, 0, 1, 0, 0},
{0, 1, 0, 0, 0, 0, 0, 0, 1, 0},
{1, 1, 0, 0, 1, 0, 1, 0, 1, 0},
{0, 1, 0, 0, 0, 0, 1, 0, 1, 0},
{1, 1, 1, 1, 1, 1, 1, 1, 1, 0}};
	
Output:
Nao existe um caminho para a saida!